AAAAAAAAAAAAAAAAAAAAAAAAAAAAAAAAAAAAAAAAAAAAAAAAAAAAAAAAAAAAAAAAAAAAAAAAAAAAAAAA
A000000000000000A00000000000000000000000000000000000000000000000000000000000000A
AA00000000000000A00000000000000000000000000000000000000000000000000000000000000A
A100000000000000000000000000000000000000000000000000000000000000000000000000000A
A200000000000000000000000000000000000000000000000000000000000000000000000000000A
A300000000000000000000000001BBBBBBBBBB00000000000000000000000000000000000000000A
AA0000000000000000000000000BBXXXXXXXXX00000000000000000000000000000000000000000A
AA000000000000000000000000000000000000000000000000000000000000000000000000000000
AA00000000000000A000000000000000000000000000000000000000000000000000000000000000
AA00000000000000A000000000000000000000000000000000000000000000000000000000000000
A000000000000000A000000000000000000000000000000000000000000000000000000000000000
AAAAAAAAAAAAAAAAA00000000002BBBBBBBBBB000000000000000000000000000000000000000000
                A0000000000BBXXXXXXXXX000000000000000000000000000000000000000000
                A000000000000000000000000000000000000000000000000000000000000000
                A000000000000000000000000000000000000000000000000000000000000000
                A000000000000000000000000000000000000000000000000000000000000000
                A000000000000000000000000000000000000000000000000000000000000000
                A00000000003BBBBBBBBBB000000000000000000000000000000000000000000
                A0000000000BBXXXXXXXXX00000000000000000000000000000000000000000A
                A00000000000000000000000000000000000000000000000000000000000000A
                A00000000000000000000000000000000000000000000000000000000000000A
                A00000000000000000000000000000000000000000000000000000000000000A
                A00000000000000000000000000000000000000000000000000000000000000A
                A00000000000000000000000000000000000000000000000000000000000000A
                AAAAAAAAAAAAAAAAAAAAAAAAAAAAAAAAAAAAAAAAAAAAAAAAAAAAAAAAAAAAAAAA