AAAAAAAAAAAAAAAAAAAAAAAAAAAAAAAAAAAAAAAAAAAAAAAAAAAAAAAAAAAAAAAAAAAAAAAAAAAAAAAA
A000000000000000A00000000000000000000000000000000000000000000000000000000000000A
AA00000000000000A00000000000000000000000000000000000000000000000000000000000000A
A400000000000000000000000000000000000000000000000000000000000000000000000000000A
A500000000000000000000000000000000000000000000000000000000000000000000000000000A
A600000000000000000000000000000000000000000000000000000000000000000000000000000A
A70000000000000000000000000BBBBBBBBBB40000000000BBBBBBBBBB700000000000000000000A
A800000000000000000000000000000000000000000000000000000000000000000000000000000A
AA00000000000000A00000000000000000000000000000000000000000000000000000000000000A
AA00000000000000A000000000000000000000000000000000000000000000000000000000000000
A000000000000000A000000000000000000000000000000000000000000000000000000000000000
AAAAAAAAAAAAAAAAA000000000000000000000000000000000000000000000000000000000000000
                A0000000000BBBBBBBBBB50000000000BBBBBBBBBB8000000000000000000000
                A000000000000000000000000000000000000000000000000000000000000000
                A000000000000000000000000000000000000000000000000000000000000000
                A000000000000000000000000000000000000000000000000000000000000000
                A00000000000000000000000000000000000000000000000000000000000000A
                A00000000000000000000000000000000000000000000000000000000000000A
                A0000000000BBBBBBBBBB600000000000000000000000000000000000000000A
                A00000000000000000000000000000000000000000000000000000000000000A
                A00000000000000000000000000000000000000000000000000000000000000A
                A00000000000000000000000000000000000000000000000000000000000000A
                A00000000000000000000000000000000000000000000000000000000000000A
                A00000000000000000000000000000000000000000000000000000000000000A
                AAAAAAAAAAAAAAAAAAAAAAAAAAAAAAAAAAAAAAAAAAAAAAAAAAAAAAAAAAAAAAAA