AAAAAAAAAAAAAAAAAAAAAAAAAAAAAAAAAAAAAAAAAAAAAAAAAAAAAAAAAAAAAAAAAAAAAAAAAAAAAAAA
A000000000000000A00000000000000000000000000000000000000000000000000000000000000A
AA00000000000000A00000000000000000000000000000000000000000000000000000000000000A
A100000000000000000000000000000000000000000000000000000000000000000000000000000A
A200000000000000000000000000000000000000000000000000000000000000000000000000000A
A30000000000000000000000000BBBBBBBBBBB0000000000BBBBBBBBBBB00000000000000000000A
A40000000000000000000000000BBXXXXXXXX10000000000BBXXXXXXXX400000000000000000000A
AA00000000000000000000000000000000000000000000000000000000000000000000000000000A
AA00000000000000A00000000000000000000000000000000000000000000000000000000000000A
AA00000000000000A000000000000000000000000000000000000000000000000000000000000000
A000000000000000A000000000000000000000000000000000000000000000000000000000000000
AAAAAAAAAAAAAAAAA0000000000BBBBBBBBBBB0000000000BBBBBBBBBBB000000000000000000000
                A0000000000BBXXXXXXXX20000000000BBXXXXXXXX5000000000000000000000
                A000000000000000000000000000000000000000000000000000000000000000
                A000000000000000000000000000000000000000000000000000000000000000
                A000000000000000000000000000000000000000000000000000000000000000
                A00000000000000000000000000000000000000000000000000000000000000A
                A0000000000BBBBBBBBBBB0000000000BBBBBBBBBBB00000000000000000000A
                A0000000000BBXXXXXXXX30000000000BBXXXXXXXX600000000000000000000A
                A00000000000000000000000000000000000000000000000000000000000000A
                A00000000000000000000000000000000000000000000000000000000000000A
                A00000000000000000000000000000000000000000000000000000000000000A
                A00000000000000000000000000000000000000000000000000000000000000A
                A00000000000000000000000000000000000000000000000000000000000000A
                AAAAAAAAAAAAAAAAAAAAAAAAAAAAAAAAAAAAAAAAAAAAAAAAAAAAAAAAAAAAAAAA