AAAAAAAAAAAAAAAAAAAAAAAAAAAAAAAAAAAAAAAAAAAAAAAAAAAAAAAAAAAAAAAAAAAAAAAAAAAAAAAA
A000000000000000A00000000000000000000000000000000000000000000000000000000000000A
AA00000000000000A00000000000000000000000000000000000000000000000000000000000000A
A100000000000000000000000000000000000000000000000000000000000000000000000000000A
A200000000000000000000000000000000000000000000000000000000000000000000000000000A
AA0000000000000000000000000BBBBBBBBBBB00000000000000000000000000000000000000000A
AA0000000000000000000000000BBXXXXXXXX100000000000000000000000000000000000000000A
AA00000000000000000000000000000000000000000000000000000000000000000000000000000A
AA00000000000000A00000000000000000000000000000000000000000000000000000000000000A
AA00000000000000A000000000000000000000000000000000000000000000000000000000000000
A000000000000000A000000000000000000000000000000000000000000000000000000000000000
AAAAAAAAAAAAAAAAA0000000000BBBBBBBBBBB000000000000000000000000000000000000000000
                A0000000000BBXXXXXXXX2000000000000000000000000000000000000000000
                A000000000000000000000000000000000000000000000000000000000000000
                A000000000000000000000000000000000000000000000000000000000000000
                A000000000000000000000000000000000000000000000000000000000000000
                A00000000000000000000000000000000000000000000000000000000000000A
                A00000000000000000000000000000000000000000000000000000000000000A
                A00000000000000000000000000000000000000000000000000000000000000A
                A00000000000000000000000000000000000000000000000000000000000000A
                A00000000000000000000000000000000000000000000000000000000000000A
                A00000000000000000000000000000000000000000000000000000000000000A
                A00000000000000000000000000000000000000000000000000000000000000A
                A00000000000000000000000000000000000000000000000000000000000000A
                AAAAAAAAAAAAAAAAAAAAAAAAAAAAAAAAAAAAAAAAAAAAAAAAAAAAAAAAAAAAAAAA