aaaaaaaaaaaaaaaaaaaaaaaaaaaaaaaaaaaaaaaaaaaaaaaaaaaaaaaaaaaaaaaaaaaaaaaaaaaaaaaa
a000000000000000a00000000000000000000000000000000000000000000000000000000000000a
aa00000000000000a00000000000000000000000000000000000000000000000000000000000000a
a100000000000000000000000000000000000000000000000000000000000000000000000000000a
a200000000000000000000000000000000000000000000000000000000000000000000000000000a
a300000000000000000000000000000000000000000000000000000000000000000000000000000a
a40000000000000000000000000bbbbbbbbbb100000000000000000000000000000000000000000a
a500000000000000000000000000000000000000000000000000000000000000000000000000000a
a600000000000000a00000000000000000000000000000000000000000000000000000000000000a
aa00000000000000a000000000000000000000000000000000000000000000000000000000000000
a000000000000000a000000000000000000000000000000000000000000000000000000000000000
aaaaaaaaaaaaaaaaa000000000000000000000000000000000000000000000000000000000000000
                a0000000000bbbbbbbbbb2000000000000000000000000000000000000000000
                a000000000000000000000000000000000000000000000000000000000000000
                a000000000000000000000000000000000000000000000000000000000000000
                a000000000000000000000000000000000000000000000000000000000000000
                a00000000000000000000000000000000000000000000000000000000000000a
                a00000000000000000000000000000000000000000000000000000000000000a
                a00000000000000000000000000000000000000000000000000000000000000a
                a00000000000000000000000000000000000000000000000000000000000000a
                a00000000000000000000000000000000000000000000000000000000000000a
                a00000000000000000000000000000000000000000000000000000000000000a
                a00000000000000000000000000000000000000000000000000000000000000a
                a00000000000000000000000000000000000000000000000000000000000000a
                aaaaaaaaaaaaaaaaaaaaaaaaaaaaaaaaaaaaaaaaaaaaaaaaaaaaaaaaaaaaaaaa 